Genus	PhaC
Microthrix	NO
Trichococcus	NO
Phosphoribacter	NO
Fastidiosipila	NO
Ferruginibacter	NO
Lentimicrobium	NO
Opimibacter	NO
Fermentibacter	NO
CL500-29_marine_group	NO
Epiflobacter	NO
Rhodobacter	YES
Thauera	YES
BD1-7_clade	NO
Thermoanaerobaculum	NO
Brachybacter	NO
Terrimonas	NO
Rhodoferax	YES
Romboutsia	NO
DMER64	NO
Methanothrix	NO
Syntrophorhabdus	NO
Lutibacillus	NO
Nitrospira	NO
Propionicimonas	NO
Paracoccus	YES
Uliginosibacterium	NO
Christensenellaceae_R-7_group	NO
Rikenellaceae_RC9_gut_group	NO
Clostridium_sensu_stricto_1	NO
Defluviibacterium	NO
Brachythrix	NO
Caldatribacterium	NO
Terrisporobacter	NO
Leptothrix	YES
Lacihabitans	NO
Cloacimonas	NO
W5	NO
Ferribacterium	YES
Azonexus	YES
Sphingorhabdus	YES
Caldilinea	NO
Dietzia	NO
Defluviicoccus	YES
Propioniciclava	NO
Acetomicrobium	NO
W5053	NO
Ahniella	YES
Ruminococcus	NO
Epilinea	NO
Hyphomicrobium	YES
SM1A02	NO
Dokdonella	YES
Competibacter	NO
Leucobacter	NO
Lautropia	YES
Smithella	NO
Nitrosomonas	NO
Proteiniclasticum	NO
Marmoricola	NO
Stenotrophobacter	NO
Streptococcus	YES
Legionella	YES
Intestinibacter	NO
Defluviimonas	NO
Gordonia	YES
Methylorosula	NO
Proximibacter	NO
Defluviifilum	NO
JGI_0001001-H03	NO
Haliangium	NO
Promineofilum	NO
Vicinibacter	NO
Nitrotoga	NO
Rhodoplanes	YES
Methylophosphatis	NO
Hydrogenophaga	YES
Brooklawnia	NO
Syntrophus	NO
Acidibacter	NO
Geothrix	NO
Thermomonas	YES
Enterococcus	NO
Subgroup_10	NO
AAP99	NO
Haliscomenobacter	NO
Tetrasphaera	NO
Brevefilum	NO
Novosphingobium	YES
Aquabacterium	YES
Bradyrhizobium	YES
Pelotomaculum	NO
Ideonella	YES
Ellin6067	NO
Iamia	NO
Micropruina	NO
Tessaracoccus	NO
Propionivibrio	NO
Aestuariimicrobium	NO
Saccharofermentans	NO
Subdoligranulum	NO
Nocardioides	YES
Accumulibacter	YES
Denitratisoma	YES
Amarofilum	NO
Sphingopyxis	YES
Stella	YES
Coprothermobacter	NO
Limnohabitans	YES
Sarcinithrix	NO
Tabrizicola	YES
Piscinibacter	YES
Proteiniphilum	NO
p-1088-a5_gut_group	NO
Pirellula	NO
Leptovillus	NO
Villigracilis	NO
Ottowia	YES
Gemmobacter	YES
Thiothrix	YES
Omnitrophus	NO
Methanomethylovorans	NO
Thermovirga	NO
Caldicoprobacter	NO
P3OB-42	NO
Pachofilum	NO
Amarolinea	NO
Neomegalonema	NO
Lactococcus	NO
Phreatobacter	YES
IMCC26207	NO
Mycobacterium	YES
Comamonas	YES
Mesorhizobium	YES
Sphingobium	YES
alphaI_cluster	NO
Ruminiclostridium	NO
Amaricoccus	NO
Propionicicella	NO
Sedimentibacter	NO
Niabella	NO
Saccharimonas	NO
Sulfuritalea	YES
Amarobacter	NO
Syntrophobacter	NO
Proteiniborus	NO
Zoogloea	NO
Cereibacter	YES
Thermogutta	NO
Ramlibacter	YES
Afipia	YES
OM27_clade	NO
Leptolinea	NO
Diaphorobacter	YES
Aeromicrobium	YES
Contendobacter	NO
OM60NOR5_clade	NO
Devosia	NO
Methanoculleus	NO
Simplicispira	YES
Irregularibacter	NO
Blastocatella	NO
Dethiobacter	NO
Limnobacter	YES
Microlunatus	NO
Nannocystis	NO
Brachymonas	NO
Leptonema	NO
Pedomicrobium	NO
Phaeodactylibacter	NO
Pseudoxanthomonas	YES
JGI-0000079-D21	NO
Hahella	YES
Runella	NO
Phosphitivorax	NO
Ercella	NO
Syntrophaceticus	NO
SC103	NO
Phenylobacterium	YES
Ilumatobacter	NO
Flexicrinis	NO
Sumerlaea	NO
Petrimonas	NO
Acinetobacter	YES
Rickettsiella	NO
Rubrivivax	YES
Rubellimicrobium	NO
Steroidobacter	YES
Pseudoclavibacter	NO
Caenimonas	NO
Bryobacter	NO
Methanolinea	NO
Anaeromyxobacter	NO
Gallionella	NO
Tissierella	NO
Sterolibacterium	NO
OLB8	NO
Kouleothrix	NO
Gemmatimonas	NO
Flavobacterium	NO
Desulfobulbus	NO
Soleaferrea	NO
Arcobacter	NO
Azospira	YES
Sneathiella	YES
Alysiosphaera	NO
Peredibacter	NO
Anaerovorax	NO
Pseudorhodobacter	YES
Lewinella	NO
Microbacterium	NO
Leptospira	YES
Obscuribacter	NO
Amarobacillus	NO
Amphiplicatus	NO
Longivirga	NO
Halomonas	YES
OLB12	NO
Pseudarcobacter	NO
Chitinivorax	NO
SH-PL14	NO
Exilispira	NO
Falsirhodobacter	NO
Galbitalea	NO
Aquimonas	NO
Alysiella	NO
Acidovorax	YES
Gallicola	NO
Lachnospiraceae_AC2044_group	NO
Cryptanaerobacter	NO
Phaselicystis	NO
Rhizobacter	NO
Conexibacter	YES
Shuttleworthia	NO
Blastopirellula	NO
Avedoeria	NO
Planctopirus	NO
Altererythrobacter	YES
Methanosarcina	NO
Frigoribacterium	NO
IheB3-7	NO
Crocinitomix	NO
Pseudomonas	YES
Ignavibacterium	NO
Trichofilum	NO
Blvii28_wastewater-sludge_group	NO
Quadrisphaera	NO
Vitreoscilla	YES
Sandaracinus	YES
Pajaroellobacter	NO
Hadersleviella	NO
Aquamicrobium	NO
Pseudochelatococcus	NO
Luteococcus	NO
Georgfuchsia	NO
Agitococcus_lubricus_group	NO
Fredericiella	NO
Pir4_lineage	NO
Allorhizobium-Neorhizobium-Pararhizobium-Rhizobium	NO
Lacunisphaera	NO
Eubacterium_brachy_group	NO
Uruburuella	NO
Hungateiclostridium	NO
YC-ZSS-LKJ63	NO
Ovatusbacter	NO
Crenothrix	NO
Caulobacter	YES
Rhodopirellula	NO
Anaerosinus	NO
Lysinimonas	NO
Aminobacter	YES
Methanospirillum	NO
Shinella	YES
Prevotella	NO
Brevundimonas	YES
Paludibacter	NO
Sphaerotilus	YES
Geobacter	NO
Polymorphobacter	YES
Ribeiella	NO
SWB02	NO
KD3-10	NO
Herbinix	NO
Mesotoga	NO
Cytophaga_xylanolytica_group	NO
Proteocatella	NO
oc32	NO
Cloacibacterium	NO
Leptotrichia	NO
Ketobacter	YES
Parafilimonas	NO
Nakamurella	YES
Paraclostridium	NO
XBB1006	NO
Roseimarinus	NO
Lysobacter	YES
Methanobacterium	NO
Ruminococcus_torques_group	NO
Syntrophomonas	YES
Aetherobacter	NO
NK4A214_group	NO
Anaerolinea	NO
Roseobacter_clade_CHAB-I-5_lineage	NO
Pseudorhodoplanes	YES
Thioclava	YES
Amnipila	NO
Luteitalea	NO
Pedobacter	NO
Paeniclostridium	NO
Roseomonas	YES
C1-B045	NO
Corynebacterium	YES
Turicibacter	NO
Moorella	NO
Parvibacillus	NO
HN-HF0106	NO
Truepera	NO
Bauldia	NO
Jatrophihabitans	NO
Clostridium_sensu_stricto_12	NO
Arenimonas	NO
S50_wastewater-sludge_group	NO
Atopobium	NO
RBG-16-49-21	NO
Demequina	NO
Dialister	NO
Eubacterium	NO
Enhydrobacter	NO
Prosthecomicrobium	NO
Lachnospiraceae_NK4A136_group	NO
Lactivibrio	NO
Desulfitibacter	NO
Eubacterium_xylanophilum_group	NO
Pseudobacteroides	NO
Acholeplasma	NO
ADurb.Bin118	NO
Salana	NO
Labrys	YES
Macellibacteroides	NO
Kineosporia	NO
Pseudochrobactrum	NO
Lactobacillus	NO
Methanothermobacter	NO
UCG-002	NO
GWE2-42-42	NO
WCHB1-32	NO
Methylobacter	NO
Actinomyces	NO
UCG-012	NO
Fusibacter	NO
Dongia	NO
Reyranella	NO
Ruminofilibacter	NO
Luteimonas	YES
Piscicoccus	NO
Acetivibrio	NO
Rhodopseudomonas	YES
Acidaminococcus	NO
Pseudaminobacter	NO
Methylotenera	NO
Cellvibrio	NO
Turneriella	NO
Georgenia	NO
Mogibacterium	NO
Thiobacillus	NO
Anaerostipes	NO
Gemmata	NO
Tsukamurella	YES
Bdellovibrio	NO
Acetobacterium	NO
Paracaedibacter	NO
Hyphomonas	YES
Cellulomonas	NO
Rhodococcus	YES
Polaromonas	YES
Treponema	NO
Fusicatenibacter	NO
Methylocystis	YES
Tepidiphilus	NO
Planctomicrobium	NO
Labilithrix	YES
Aeromonas	YES
Aurantisolimonas	NO
Dorea	NO
Fluviicola	NO
Cellulosilyticum	NO
Kaistia	YES
Halioglobus	YES
Psychrobacter	YES
Papillibacter	NO
Sva0996_marine_group	NO
SH3-11	NO
Ralstonia	YES
Flexifilum	NO
Bythopirellula	YES
Roseovarius	YES
Leifsonia	NO
CL500-3	NO
Keratinibaculum	NO
Bosea	YES
Lachnospiraceae_UCG-004	NO
Sarcina	NO
Leuconostoc	NO
CM1G08	NO
Desulforudis	NO
Polynucleobacter	YES
Herpetosiphon	NO
Cephaloticoccus	NO
Hirschia	YES
Salinispira	NO
Sulfurovum	NO
Agathobacter	NO
Aliterella	NO
Pseudolabrys	YES
Persicitalea	NO
TM7a	NO
Laribacter	YES
Rivibacter	NO
Bacteroides	NO
Thermanaerovibrio	NO
Chryseobacterium	NO
Roseburia	NO
Aridibacter	NO
Nostocoida	NO
Nordella	YES
LNR_A2-18	NO
966-1	NO
Blastochloris	YES
Sanguibacter-Flavimobilis	NO
Veillonella	NO
Diaminobutyricimonas	NO
Polyangium	YES
Mariniphaga	NO
Hoeflea	YES
Tepidimicrobium	NO
Monoglobus	NO
Syner-01	NO
Taibaiella	NO
Sphingomonas	YES
Curvibacter	NO
Flavitalea	NO
Rhodanobacter	YES
GOUTA6	NO
Acidipropionibacterium	NO
Defluviitalea	NO
Defluviitoga	NO
BSV13	NO
Aquicella	YES
Butyrivibrio	NO
Filomicrobium	YES
Stenoxybacter	NO
Millisia	NO
Cutibacterium	NO
Armatimonas	NO
Fervidobacterium	NO
Desulforhabdus	NO
Bellilinea	NO
Gaiella	NO
Rivicola	NO
Minicystis	YES
Aquincola	YES
Lachnospiraceae_NK3A20_group	NO
Propionibacterium	NO
Megasphaera	NO
Flexilinea	NO
Flavimaricola	NO
Mobilitalea	NO
Rhizorhapis	NO
Levilinea	NO
Bavariicoccus	NO
MND1	NO
Singulisphaera	NO
Clostridium_sensu_stricto_5	NO
C-2	NO
Alicycliphilus	YES
Lachnoclostridium	NO
Rhodovastum	YES
Serratia	NO
Agreia	NO
Hydrogenedens	NO
Anammoximicrobium	NO
Dehalobacterium	NO
Azoarcus	YES
Prosthecobacter	NO
Spirochaeta_2	NO
Alterococcus	NO
Pseudorhodoferax	NO
Arthrobacter	YES
Blautia	NO
Ruminococcus_gauvreauii_group	NO
Stenotrophomonas	YES
Desulfococcus	YES
Fluviicoccus	NO
dgA-11_gut_group	NO
Eubacterium_nodatum_group	NO
Puniceicoccus	NO
Cryobacterium	NO
Oscillibacter	NO
Aminiphilus	NO
Fimbriiglobus	NO
Methanofastidiosum	NO
OLB17	NO
UKL13-1	NO
Oikopleura	NO
Edaphobaculum	NO
Parafrigoribacterium	NO
Colidextribacter	NO
Akkermansia	NO
UTBCD1	NO
Weissella	NO
Flavihumibacter	NO
Longilinea	NO
Eggerthella	NO
Verticiella	NO
Coprococcus	NO
Erysipelothrix	NO
Sporanaerobacter	NO
Xanthobacter	YES
Opitutus	NO
Megaira	NO
Lacticaseibacillus	NO
Solibacter	NO
Hassallia	NO
Raineyella	NO
Desulfurispora	NO
Aminobacterium	NO
Tepidanaerobacter_acetatoxydans_Re1	NO
Tepidamorphus	NO
Zavarzinella	NO
Nitrosospira	NO
Membranicola	NO
Anaerofustis	NO
Inquilinus	NO
Abditibacterium	NO
Byssovorax	NO
Moraxella	YES
Telmatocola	NO
Pir3_lineage	NO
Leadbetterella	NO
Methanocorpusculum	NO
Methanobrevibacter	NO
Methanosphaera	NO
Staphylococcus	NO
Bacillus	YES
Salmonella	NO
Escherichia-Shigella	NO
Campylobacter	NO
Vibrio	YES
Yersinia	NO
Helicobacter	NO
Methanococcoides	NO
Methanolobus	NO
Methanoregula	NO
Methanosphaerula	NO
Methanomassiliicoccus	NO
Methanocaldococcus	NO
Pyrococcus	NO
Methanocella	NO
Methanothermus	NO
Methanofollis	NO
Methanolacinia	NO
Enterobacter	NO
Bipolaricaulis	NO
Nitrobacter	YES
Brocadia	NO
Pleurocapsa_PCC-7319	NO
Sediminibacterium	NO
TM7x	NO
Tricholinea	NO
Carnobacterium	NO
Wilmottia_Ant-Ph58	NO
Glutamicibacter	NO
Defluviilinea	NO
Tychonema_CCAP_1459-11B	NO
C39	NO
JdFR-76	NO
Alcaligenes	YES
MM1	NO
Subsaxibacter	NO
Dyadobacter	NO
Porphyrobacter	YES
Brochothrix	NO
Azovibrio	NO
Methyloversatilis	YES
Flavisolibacter	NO
Plasticicumulans	NO
Leptolyngbya_PCC-6306	NO
Wolinella	NO
Ruegeria	YES
Lelliottia	NO
Inhella	NO
Maritimibacter	NO
Floricoccus	NO
Alkanindiges	NO
Denitromonas	NO
Methylocella	YES
Thiobios	NO
Pythium_ultimum	NO
Rheinheimera	NO
Syntrophobotulus	NO
Methylocaldum	YES
Segetibacter	NO
Castellaniella	YES
Cytophaga	NO
Methylobacillus	NO
Ornatilinea	NO
Tepidisphaera	NO
Chelativorans	YES
Chujaibacter	NO
Bacteriovorax	NO
Myroides	NO
GKS98_freshwater_group	NO
Ignatzschineria	NO
Immundisolibacter	YES
Silvanigrella	NO
Methyloceanibacter	YES
Lutimaribacter	NO
Niveibacterium	YES
Hypnocyclicus	NO
Latilactobacillus	NO
Desulfomonile	YES
Solobacterium	NO
Methylophilus	NO
Brachybacterium	NO
Family_XIII_AD3011_group	NO
UTCFX1	NO
Nitratireductor	YES
Rurimicrobium	NO
Fulvivirga	NO
Bact-08	NO
Emticicia	NO
Erythrobacter	YES
OLB15	NO
Flavicella	NO
Sandaracinobacter	NO
Parvibaculum	YES
Solitalea	NO
Francisella	NO
Catenisphaera	NO
UBA6140	NO
Haoranjiania	NO
gamma_proteobacterium_OR-113	NO
Vagococcus	NO
Albirhodobacter	NO
Sulfuriferula	NO
Prevotella_9	NO
Marivita	NO
Chelatococcus_asaccharovorans	NO
Alistipes	NO
Sphingosinicella	YES
Neisseria	YES
Oceanobacter	NO
Thiopseudomonas	YES
Thiocapsa	YES
Sagittula	YES
Rubinisphaera	NO
Moheibacter	NO
Spirochaeta	NO
Pelolinea	NO
Undibacterium	YES
Lutibacter	NO
Taeseokella	NO
Vicingus	NO
Meiothermus	NO
Algoriella	NO
Quatrionicoccus	YES
Leucothrix	NO
Paucibacter	NO
Algoriphagus	NO
Methyloparacoccus	NO
Rickettsia	YES
Acidocella	YES
Parabacteroides	NO
Litorilinea	NO
Methylibium	YES
Beggiatoa	YES
Koukoulia	NO
Donghicola	NO
Hylemonella	YES
Mariniflexile	NO
Mycoplasma	NO
Tolumonas	YES
Skermania	YES
Empedobacter	NO
Erysipelotrichaceae_UCG-003	NO
Albibacter	NO
Paenalcaligenes	NO
Luteibacter	YES
Chlorobium	NO
Giesbergeria	NO
Bordetella	YES
Variovorax	YES
Pannonibacter	YES
Arcicella	NO
Pythium_insidiosum	NO
Kocuria	NO
Paeniglutamicibacter	NO
Kluyvera	NO
Oricola	YES
Malikia	NO
Coxiella	NO
Sphingobacterium	NO
Nodosilinea_PCC-7104	NO
Sebaldella	NO
Pelomonas	NO
Paucilactobacillus	NO
Methylosarcina	NO
Sporocytophaga	NO
MSBL3	NO
Holdemanella	NO
Ulvibacter	NO
Schlesneria	NO
Lysinibacillus	NO
Draconibacterium	NO
Ligilactobacillus	NO
ZOR0006	NO
Chryseolinea	NO
Cellulophaga	NO
Nioella	NO
Caproiciproducens	NO
Chamaesiphon_PCC-6605	NO
Nucleicultrix	YES
Chondromyces	YES
CI75cm.2.12	NO
Polyangium_brachysporum_group	NO
Anaerocella	NO
Sedimentitalea	NO
Pseudohongiella	NO
Anaerolineaceae_UCG-001	NO
Timonella	NO
Bergeyella	NO
Mangroviflexus	NO
Leptothrix_sp._FC_170	NO
Sedimenticola	YES
Azorhizobium	YES
Clostridium_sensu_stricto_13	NO
Sulfurospirillum	NO
CENA359	NO
Geminocystis_PCC-6308	NO
Peptostreptococcus	NO
Miniimonas	NO
Robiginitalea	NO
Flectobacillus	NO
Flexivirga	NO
Oligoflexus	NO
mixed_culture_isolate_koll13	NO
Candidimonas	NO
Marinicella	NO
Desulfatitalea	NO
Ochrobactrum	NO
Tepidimonas	YES
Kineosphaera	NO
Caldisericum	NO
Achromobacter	YES
Sideroxydans	NO
Soonwooa	NO
Thermodesulfobium	NO
Spirosoma	NO
Prevotella_7	NO
Sulfurimonas	NO
Gaetbulibacter	NO
Tropicimonas	NO
Acidaminobacter	NO
Schumannella	NO
Dysgonomonas	NO
IMCC26134	NO
Sporosarcina	YES
Klebsiella	NO
Primorskyibacter	NO
Hydromonas_sp._F02	NO
Phormidesmis_ANT.LACV5.1	NO
Salinibacterium	NO
BIyi10	NO
Parablastomonas	NO
Extensimonas	NO
Berkiella	NO
SD04E11	NO
Endoecteinascidia	NO
Trichlorobacter	NO
Aequorivita	NO
Rhodobium	NO
Dechlorobacter	NO
Odyssella	NO
Calorithrix	NO
Sva0081_sediment_group	NO
Marinoscillum	NO
Dinghuibacter	NO
Desulfomicrobium	NO
Sphingoaurantiacus	NO
Desulfobacter	NO
Sulfuricurvum	NO
Janthinobacterium	YES
Psychromonas	NO
Pseudanabaena_PCC-7429	NO
Holospora	NO
TPD-58	NO
Desulfobacterium_catecholicum_group	NO
AKYG587	NO
Aminivibrio	NO
Microbacter	NO
Raoultella	NO
FukuN57	NO
Parasediminibacterium	NO
CAG-352	NO
Desulforhopalus	NO
KCM-B-112	NO
Propionispira	NO
Ruminococcus_gnavus_group	NO
Seohaeicola	NO
Hymenobacter	NO
S5-A14a	NO
Bernardetia	YES
Eubacterium_hallii_group	NO
Seleniivibrio	NO
Bogoriella	NO
Anaerofilum	NO
DSSF69	NO
Methylomicrobium	NO
Janibacter	YES
Acetitomaculum	NO
Lapillicoccus	NO
JTB255_marine_benthic_group	NO
Granulosicoccus	YES
Methyloferula	NO
RBG-16-58-14	NO
Arsenicibacter	NO
Aliiroseovarius	YES
Aerosphaera	NO
Dichloromethanomonas	NO
Mobilicoccus	NO
Desulfovermiculus	NO
Acetonema	NO
Herminiimonas	YES
Aureispira	NO
Cetobacterium	NO
Sandarakinorhabdus	NO
Rhodovarius	NO
Soehngenia	NO
Xenophilus	NO
Kinneretia	NO
Catenibacterium	NO
Starkeya	YES
Desulfosarcina	YES
Clostridium_sensu_stricto_9	NO
Roseococcus	NO
Fluviimonas	NO
Blastomonas	YES
UCG-004	NO
I-8	NO
Leptolyngbya_ANT.L52.2	NO
Lacibacter	NO
Endomicrobium	NO
Methylobacterium-Methylorubrum	NO
Haematobacter	YES
Portibacter	NO
Urania-1B-19_marine_sediment_group	NO
Thioalkalispira-Sulfurivermis	NO
Desulfovibrio	NO
Yonghaparkia	NO
Aquaspirillum	YES
Ancylobacter	YES
Clostridium_sensu_stricto_18	NO
Cavicella	NO
Pseudopelobacter	NO
Acanthopleuribacter	NO
Siphonobacter	NO
Silicimonas	YES
Actibacter	NO
Pelosinus	NO
Eubacterium_ventriosum_group	NO
Nitrospina	NO
Cupriavidus	YES
Variibacter	YES
Citrobacter	NO
Vitellibacter	NO
Anaerospora	NO
Ferritrophicum	NO
Serinibacter	NO
Chryseoglobus	NO
Caedibacter	NO
Chthonobacter	NO
Occallatibacter	YES
Azospirillum	YES
Rahnella1	NO
Cryomorpha	NO
UCG-005	NO
Chroococcidiopsis_PCC_7203	NO
Paenirhodobacter	YES
Phascolarctobacterium	NO
Zymophilus	NO
Synechococcus_PCC-7902	NO
Pontibaca	NO
Idiomarina_sp.	NO
Asticcacaulis	YES
Syntrophotalea	NO
Woeseia	NO
Chroococcidiopsis_PCC-6712	NO
Maribacter	NO
Lachnospiraceae_ND3007_group	NO
Ferrovibrio	YES
Hespellia	NO
Gimesia	NO
Pseudodonghicola	NO
Cerasicoccus	NO
CAG-56	NO
Actinotalea	NO
Sorangium	YES
Vampirovibrio	NO
AUTHM297	NO
Trichloromonas	NO
Rhodobacter_sp._JA431	NO
Thiomonas	YES
Methylomonas	NO
Rubribacterium	NO
Riegeria	NO
Luteolibacter	NO
Fuerstia	NO
Rudaea	NO
Noviherbaspirillum	YES
Schleiferia	NO
HdN1	NO
Lachnospira	NO
Tuwongella	NO
Arenibacter	NO
Amoebophilus	NO
Desulfofustis	NO
Limosilactobacillus	NO
Prevotellaceae_UCG-004	NO
Eubacterium_eligens_group	NO
Chlorella_sorokiniana	NO
Chitinimonas	YES
Rhodobaculum	NO
SEEP-SRB1	NO
Formivibrio	NO
DEV114	NO
Camelimonas	NO
Z-35	NO
Sulfitobacter	YES
Methyloterrigena	NO
Geitlerinema_PCC-7105	NO
Ancalomicrobium	NO
Actinobacillus	NO
Succiniclasticum	NO
Gordonibacter	NO
Smaragdicoccus	NO
Desulfoprunum	NO
Marinicaulis	NO
Holophaga	NO
Pseudonocardia	YES
Saccharicrinis	NO
Delftia	YES
Clostridium_sensu_stricto_11	NO
Pedococcus-Phycicoccus	NO
Elizabethkingia	NO
Lactiplantibacillus	NO
Granulicella	NO
MN_122.2a	NO
Actibacterium	YES
Oligotropha	NO
Pseudohoeflea	NO
Erysipelatoclostridium	NO
Clostridium_sensu_stricto_7	NO
Pleomorphomonas	YES
Pseudenhygromyxa	NO
Thiosymbion	NO
Wandonia	NO
Verruc-01	NO
Eubacterium_ruminantium_group	NO
Dehalobacter	NO
Rhodoblastus	YES
Anaerosalibacter	NO
Hathewaya	NO
Jeotgalibaca	NO
Parvibium	NO
Sporobacter	NO
Chelatococcus	YES
Rubritepida	NO
Geminicoccus	NO
Fibrobacter	NO
Pectinatus	NO
Raoultibacter	NO
Pseudoxanthobacter	NO
Aestuariicoccus	NO
Dolosicoccus	NO
Loigolactobacillus	NO
Captivus	NO
Yoonia-Loktanella	NO
Pseudahrensia	NO
mle1-7	NO
Ensifer	YES
Puia	NO
Gaiella_sp._EBR4-RS1	NO
Acetoanaerobium	NO
Aquaspirillum_arcticum_group	NO
Crenobacter	YES
Aquibacter	NO
Parvimonas	NO
Deinococcus	NO
Desulfotalea	NO
Caenispirillum	NO
Desulfocapsa	NO
Raineya	NO
Sediminispirochaeta	NO
Mitsuaria	NO
Desulforegula	NO
Polaribacter	NO
Pelagibacterium_sp.	NO
Budvicia	NO
Fibrisoma	NO
Breznakia	NO
Methyloglobulus	NO
Leeia	NO
Shewanella	YES
Succinispira	NO
Paenochrobactrum	NO
Paludibacterium	NO
Brevibacterium	NO
Roseobacter_clade_NAC11-7_lineage	NO
Oleiphilus	YES
Arachidicoccus	NO
Nubsella	NO
Aerococcus	NO
Mucilaginibacter	NO
Lapidilactobacillus	NO
Stappia	YES
RB41	NO
Thiobaca	NO
Marinifilum	NO
MM2	NO
Gloeocapsa_PCC-7428	NO
Chloronema	NO
Citrifermentans	NO
Andreesenia_angusta	NO
Alkalibacterium	NO
Bealeia	NO
Kribbella	NO
Clostridium_sensu_stricto_10	NO
Clostridium_sensu_stricto_16	NO
Propionibacterium_sp._Marseille-P4482	NO
Eubacterium_fissicatena_group	NO
Rudanella	NO
Tuber_borchii_symbiont_b-17BO	NO
Dellaglioa	NO
Jannaschia	YES
Novispirillum	NO
Rhodobacter_veldkampii	NO
UCG-007	NO
Histiona_aroides	NO
Rhodovulum	YES
UCG-008	NO
JCM_18997	NO
Qipengyuania	YES
Amylolactobacillus	NO
Chelonobacter	NO
Insolitispirillum	NO
Frisingicoccus	NO
Pleurocapsa_PCC-7327	NO
SM23-31	NO
Hypsibius_dujardini	NO
Acetobacter	NO
Parapusillimonas	NO
Megamonas	NO
Buttiauxella	NO
Verrucomicrobium	NO
Aestuariimonas	NO
Paludicola	NO
Tyzzerella	NO
UBA1819	NO
Ignavigranum	YES
Lacticigenium	NO
Homoserinibacter	NO
Mariprofundus	NO
Desulfosporosinus	NO
Labrenzia	YES
Thiodiazotropha	NO
Pseudofulvimonas	NO
Faecalibacterium	NO
Tenacibaculum	NO
Odoribacter	NO
Planococcus	NO
Prevotellaceae_UCG-001	NO
Fr127	NO
Electronema	NO
Klugiella	NO
Silanimonas	NO
Wautersiella	NO
Secundilactobacillus	NO
Caedibacter_taeniospiralis_group	NO
Eoetvoesia	NO
Flaviflexus	NO
Planktothrix_NIVA-CYA_15	NO
Stoquefichus	NO
Rathayibacter	NO
Magnetospirillum	YES
Facklamia	NO
Pricia	NO
Promineofilum_breve	NO
Anaerosporobacter	NO
Halobacteriovorax	NO
Pseudarcicella	NO
Gortzia	NO
Paenibacillus	NO
Ohtaekwangia	NO
OLB13	NO
Reclinomonas_americana_ATCC_50284	NO
Massilia	YES
Owenweeksia	NO
Defluviitaleaceae_UCG-011	NO
Pelistega	NO
Pseudopropionibacterium	NO
Lachnospiraceae_UCG-007	NO
Paraprevotella	NO
Flexibacter	NO
Salinirepens	NO
Sinorhizobium_sp._RAC02	NO
Lentilactobacillus	NO
Asaccharospora	NO
Desulfuromusa	NO
Alcanivorax	YES
Arsenicicoccus	NO
Peptoclostridium	NO
Paraglaciecola	NO
Anderseniella	NO
Filimonas	NO
Formosa	NO
Tahibacter	YES
Erysipelotrichaceae_UCG-006	NO
Schizothrix_LEGE_07164	NO
Barnesiella	NO
Ponticoccus_sp._MM4	NO
Citreicella	NO
Hansschlegelia	NO
Anaerovibrio	NO
Agrococcus	NO
Dechlorosoma	NO
Lachnospiraceae_UCG-008	NO
Clostridium_sensu_stricto_15	NO
Anaerorhabdus_furcosa_group	NO
Achromobacter_xylosoxidans	NO
Chromobacterium	YES
Marinagarivorans	NO
Eubacterium_siraeum_group	NO
Granulicatella	NO
Epulopiscium	NO
Selenomonas	NO
Sulfurisoma	NO
Desulfatiglans	NO
Rubrimonas	NO
Mitsuokella	NO
Christensenella_sp._Marseille-P2437	NO
Family_XIII_UCG-001	NO
Wohlfahrtiimonas	NO
Larkinella	NO
Conchiformibius	NO
Succinivibrio	NO
Propionimicrobium	NO
Cohaesibacter	NO
Mf105b01	NO
Thiohalocapsa	YES
Povalibacter	NO
Ciceribacter	NO
Microvirga	YES
Dehalococcoides	NO
Thiococcus	NO
FFCH5858	NO
Micrococcus	NO
Protistobacter_heckmanni	NO
DEV008	NO
Pasteuria	NO
Sporolactobacillus	NO
Rhodopila	NO
Sporomusa	NO
Sphaerochaeta	NO
Williamwhitmania	NO
NS10_marine_group	NO
Fonticella	NO
Lachnospiraceae_UCG-001	NO
Duganella	YES
Rhodocyclus	NO
Desulfuromonas	NO
Fusobacterium	NO
Victivallis	NO
Vogesella	YES
Sellimonas	NO
Porticoccus	NO
LD29	NO
Rothia	NO
Croceicoccus	YES
Fructilactobacillus	NO
Endonucleariobacter	NO
Oxalicibacterium	NO
Microterricola	NO
Trueperella	NO
Methylovulum	NO
Pir2_lineage	NO
Zhizhongheella	NO
Diplosphaera	NO
Elstera	NO
EBM-39	NO
ADurb.Bin063-1	NO
Ampullimonas	NO
Balneola	NO
Brevifollis	NO
Dethiosulfovibrio	NO
Rhodomicrobium	YES
Cellulosimicrobium	NO
Phyllobacterium	YES
Marvinbryantia	NO
Muricauda	NO
Desulfatiferula_olefinivorans	NO
Gelidibacter	NO
Thiolamprovum	NO
UCG-003	NO
Tundrisphaera	NO
Acidomonas	NO
Chthoniobacter	NO
Hafnia-Obesumbacterium	NO
Daeguia	NO
Lachnospiraceae_FCS020_group	NO
Anaeromusa-Anaeroarcus	NO
Finniella	NO
Lachnospiraceae_XPB1014_group	NO
Desulfatirhabdium	NO
Phaeobacter	YES
Parasporobacterium	NO
Holdemania	NO
Cloacibacillus	NO
Lysinimicrobium	NO
Butyricicoccus	NO
Rubrivirga	NO
Pediococcus	NO
Chiayiivirga	NO
Tenderia	NO
pItb-vmat-59	NO
Rubripirellula	NO
Xanthomonas_citri_pv._mangiferaeindicae	NO
Bizionia	NO
Permianibacter	YES
Chthonomonas	NO
Alloprevotella	NO
Atopostipes	NO
Sutterella	NO
Knoellia	NO
Desulfobacula_sp._TS	NO
Howardella	NO
Anoxybacillus	YES
Curtobacterium	NO
Cyanobium_PCC-6307	NO
Pasteurella	NO
Pelagibacterium	NO
Alkaliphilus_oremlandii_OhILAs	NO
Nocardiopsis	NO
Elioraea	YES
UCG-009	NO
Desulfobacca	NO
Methyloterricola	NO
Procabacter	NO
Pusillimonas	YES
Dyella	YES
Deefgea	YES
Vulgatibacter	NO
Merdibacter	NO
Ekhidna	NO
Humibacillus	NO
Prevotellaceae_NK3B31_group	NO
Schleiferilactobacillus	NO
Acidisoma	NO
Reinekea	NO
Luethyella	NO
Fretibacterium	NO
Aurantimicrobium	NO
Solirubrobacter	NO
Terrimicrobium	NO
Arcanobacterium	NO
Yeosuana	NO
Anaerostignum	NO
mixed_culture_isolate_koll11	NO
U29-B03	NO
Pseudorhodobacter_sp.	NO
Geitlerinema_LD9	NO
Xiphinematobacter	NO
Faecalitalea	NO
Salmonella_sp._JPunk1-2	NO
Parasegetibacter	NO
Limnothrix	NO
Aurantimonas_sp._USBA_369	NO
Latescibacter	NO
Desulfarculus	NO
Pseudactinotalea	NO
Enhygromyxa_sp._SAB-1	NO
Azotobacter	YES
Arsenicitalea	NO
Allochromatium	YES
Micavibrio	YES
Tianweitania	NO
Clostridium_sensu_stricto_4	NO
Tuzzerella	NO
Rhodocytophaga	NO
Acuticoccus	YES
Aquisphaera	YES
Sulfitobacter_sp._GC02	NO
Xanthomarina	NO
RS25G	NO
SN8	NO
Thermobrachium	NO
Exiguobacterium	NO
Rhodobacter_sp._BACL10_MAG-120910-bin24	NO
Oceaniovalibus	NO
Midichloria	YES
Thioalkalivibrio	YES
MSBL7	NO
Dysgonomonas_sp._BGC7	NO
Symbiobacter	NO
Reclinomonas_americana_ATCC_50283	NO
Cm1-21	NO
Neochlamydia	NO
Desulfopila	NO
Antricoccus	NO
Macromonas	NO
Ornithinibacter	NO
Desulfovirga	NO
Christensenella	NO
Haloferula	NO
Clostridium_sensu_stricto_3	NO
Actinothuidium_hookeri	NO
Globicatella	NO
Qingshengfania	NO
Fermentimonas	NO
Lampropedia	NO
Niastella	NO
Youngiibacter	NO
Rubrobacter	YES
Hugenholtzia	NO
Advenella	YES
Angelakisella	NO
Ornithinimicrobium	YES
Pseudocitrobacter	NO
Alkalibacter	NO
Lactovum	NO
Roseimicrobium	NO
CK06-06-Mud-MAS4B-21	NO
Thermoflavimicrobium	NO
Ureibacillus	YES
Liquorilactobacillus	NO
Clostridium_sensu_stricto_2	NO
Sulfurifustis	NO
Subgroup_23	NO
Cerasibacillus	NO
Pygmaiobacter	NO
Humibacter	NO
Vulcanibacillus	NO
Edaphobacter	NO
Rugamonas	YES
Lachnospiraceae_UCG-003	NO
Oligosphaera	NO
Asteroleplasma	NO
Psychroglaciecola	NO
Pigmentiphaga	YES
Oerskovia	NO
Iodobacter	YES
Levilactobacillus	NO
Pseudogracilibacillus	NO
Thermoanaerobacterium	NO
Halocella	NO
Methanoplasma	NO
Anaerococcus	YES
Virgibacillus	NO
Clostridium_sensu_stricto_8	NO
Z20	NO
RumEn_M2	NO
GWE2-31-10	NO
Oligella	YES
Tepidanaerobacter_acetatoxydans	NO
Peptoniphilus	YES
Clostridium_sp._JC3	NO
Methanogranum	NO
Anaerosphaera	NO
Maritimimonas	NO
Methanomethylicus	NO
Bifidobacterium	NO
Syntrophothermus	NO
ADurb.Bin063-2	NO
Lawsonella	NO
Diapherotrites_archaeon_ADurb.Bin253	NO
Microcystis_PCC-7914	NO
Syntrophococcus	NO
Oceanotoga	NO
Ellin516	NO
Nitrocosmicus	NO
R76-B128	NO
Olsenella	NO
Lactonifactor	NO
Erysipelotrichaceae_UCG-009	NO
Erysipelotrichaceae_UCG-007	NO
Methanimicrococcus	NO
Moduliflexus	NO
M2PT2-76_termite_group	NO
Pseudoramibacter	NO
Thermoclostridium	NO
Thermobifida	NO
Savagea	NO
Helcococcus	NO
Haloplasma	NO
Oribacterium	NO
Enteractinococcus	NO
Intestinimonas	NO
28-4	NO
Elusimicrobium	NO
horsej-a03	NO
Marinobacter	YES
Sharpea	NO
Meniscus	NO
Yaniella	NO
Companilactobacillus	NO
Marinospirillum	NO
Aggregatibacter	NO
Clostridium_sensu_stricto_6	NO
Jeotgalicoccus	NO
Porphyromonas	NO
Acetobacteroides	NO
Erysipelotrichaceae_UCG-002	NO
Murdochiella	NO
Oblitimonas	NO
probable_genus_10	NO
Moellerella	NO
Aeriscardovia	NO
Thermoactinomyces	NO
CPla-4_termite_group	NO
Anaerocolumna	NO
Faecalicoccus	NO
Paludisphaera	NO
Psychrobacillus	NO
Amphibacillus	NO
Sanguibacteroides	NO
Negativicoccus	NO
Oxobacter	NO
Pseudobutyrivibrio	NO
Tepidanaerobacter_syntrophicus	NO
Anaerobium	NO
Rummeliibacillus	NO
Tetragenococcus	NO
Symbiobacterium	NO
Brevibacillus	YES
Aminomonas	NO
Planifilum	NO
Alkaliflexus	NO
Marinactinospora	NO
Collinsella	NO
H1	NO
Tomitella	YES
Lachnotalea	NO
Paraeggerthella	NO
Schwartzia	NO
Thermodesulfovibrio	NO
Saccharopolyspora	NO
Oceanobacillus	NO
Laceyella	NO
Desulfuribacillus	NO
Clostridium_innocuum_group	NO
Fungi	NO
Providencia	NO
Parasutterella	NO
Christensenella_sp._AF73-05CM02	NO
Pyramidobacter	NO
Kroppenstedtia	NO
Propionispora_sp.	NO
Sporacetigenium	NO
Thermocrispum	NO
Ammoniibacillus	NO
Melghirimyces	NO
Neoscardovia	NO
Senegalimassilia	NO
Auricoccus-Abyssicoccus	NO
Aliidiomarina	NO
Idiomarina	NO
Pseudoclostridium	NO
Clostridium_sensu_stricto_14	NO
Glycomyces	NO
Rhodoligotrophos	NO
SCADC1-2-3	NO
Haloimpatiens	NO
Melioribacter	NO
Salinicoccus	NO
Kurthia	NO
Desulfallas-Sporotomaculum	NO
Novibacillus	NO
Caldanaerobacter	NO
Actinomycetospora	YES
Saccharopolyspora_rectivirgula	NO
Veillonellaceae_UCG-001	NO
Nocardia	YES
Saccharomonospora	NO
Clostridium_sp._BMD1	NO
Pseudarthrobacter	NO
Desulfocarbo	NO
Lachnospiraceae_NC2004_group	NO
Solibacillus	NO
Aquiluna	NO
DNF00809	NO
Sh765B-TzT-35	NO
Moryella	NO
Negativibacillus	NO
Lachnospiraceae_NK4B4_group	NO
Ruminobacter	NO
Oenococcus	NO
Ethanoligenens	NO
Geobacillus	NO
Micromonospora	NO
Nannochloropsis_limnetica	NO
Pelospora	NO
Aestuariicella	NO
Bombilactobacillus	NO
Thermosyntropha	NO
Hazenella	NO
Methanomethylophilus	NO
archaeon_enrichment_culture_clone_A11	NO
Anaerotruncus	NO
Nitrosarchaeum	NO
Peptococcus	NO
Acidiphilium	YES
Thiomicrospira	NO
FukuN18_freshwater_group	NO
hoa5-07d05_gut_group	NO
Longispora	NO
Halothiobacillus	NO
Termite_planctomycete_cluster	NO
V9D2013_group	NO
delta_proteobacterium_MLS_D	NO
Alkaliphilus_crotonatoxidans	NO
Bhargavaea	NO
Brevinema	NO
